00000000000000000000
00000000020000000000
00000110020011000000
00000110020011000000
00000100020001000000
00011100020001110000
00000000020000000000
00000000020000000000
00011100020001110000
00000100020001000000
00000110020011000000
00000110020011000000
00000000020000000000
00000000000000000000