11111111111111111111
10000000000000000001
10222222222222222201
12221101000011010201
10200000000000000201
10201000000000010201
10200000000000000201
10201000000000010201
10200000000000000201
10201101000011010201
10200000022200000201
10200000021200000201
10222222221222222201
11111111111111111111
