11111111111111111111
10000000000000000001
10000000000000000001
10011111100111111001
10010000000000001001
10010000000000001001
10000000000000000001
10000000000000000001
10010000000000001001
10010000000000001001
10011111100111111001
10000000000000000001
10000000000000000001
11111111111111111111
