11111111111111111111
10000000000000000001
10110000111100011101
10110011100111001001
10000010000001001001
10000100000000100001
10000100000000100001
10002222222222220001
10002100000000120001
10002100000000120001
10002111100111120001
10002222222222220001
10000000000000000001
11111111111111111111
