11111111111111111111
10000000000000000001
10000000000000000001
10022222222222222201
10020100000000010201
10020000000000000201
10020100000000010201
10020000000000000201
10020101010101010201
10020000000000000201
10020000000000000201
10010010101010100101
10000000000000000001
11111111111111111111
