00000000000000000000
00000000000000000000
00100000000000000010
00001000000000001000
00000010001000100000
00000000100010000000
00000000000000000000
00000000000010000000
00000000101000100000
00000010000000001000
00001000000000000010
00100000000000000000
00000000000000000000
00000000000000000000
