00000000000000000000
00000000000000000000
00000000000000000000
00001111111111110000
00001000000000010000
00000000000000000000
00000000000000000000
00000000000000000000
00000000000000000000
00001000000000010000
00001111111111110000
00000000000000000000
00000000000000000000
00000000000000000000