00000000000000000000
00000000000000000000
00000111111111100000
00000000000000000000
00100000000000000000
00100000000000000000
00100000000000000000
00100000000000000000
00100000000000000000
00000001111111100000
00000000000000000000
00000000000000000000
00000000000000000000
00000000000000000000