11111111111111111111
10000000000000000001
10022222222222222001
10222222222222222001
10020000000000002001
10000000000000000001
11110000000000001111
10000000000000000001
10000011000011000001
10000100000000100001
10001000001000010001
10110000001000001101
10000000001000000001
11111111111111111111
