11111111111111111111
10000000000000000001
10222222222222222201
10200000100100000201
10200000100100000201
10200011100111000201
10200000000000000201
10200011100111000201
10000000100100000201
10200000100100000201
10200000000000000201
10222222222222222201
10000000000000000201
11111111111111111111
