11111111111111111111
10000122222222200001
10002220001100210001
10002100010010200001
10002000000000210001
10002100000000200001
10002000000000210001
10002100000000200001
10002000000000210001
10002100000000200001
10002000100100210001
10002100011000200001
10002222222222210001
11111111111111111111
