11111111111111111111
10000000000000000001
10001000000000000001
10001100000001111001
10001000000000100001
10100000100000000001
10100000110000000001
10100000010000000001
10000000000000011101
10000000000000000101
10000000000000000001
10011110000000110001
10011111000100110001
11111111111111111111
