11111111111111111111
10000000001000000001
10000000001000000001
10001111111111110001
10001000000000010001
10000000000000000001
12222222222222222221
10000000000000000001
10000000000000010001
10001000000000010001
10001111111111110001
10000000001000000001
10000000001000000001
11111111111111111111
