00000000000000000000
00000000000000000000
00000000000000000000
00000011100011100000
00000000000000000000
00000000000000000000
00000000000000000000
00001111000001111000
00000000000000000000
00000000000000000000
00001111100011111000
00000000000000000000
00000000000000000000
00000000000000000000
