11111111111111111111
10000222222222220001
10000200011100020001
10100201100011020001
10010210100000120001
10100210100000120001
10100200002222220001
10010210002000100001
10010211102011100001
10000210002000100001
10000211002001100001
10000222222000000001
10000000000000000001
11111111111111111111
