11111111111111111111
10000000000000000001
10000000000000000001
10011100111000000001
10000100100000001001
10000111100000001001
10000000000000001001
10000000000000000001
10010000000111100001
10010000000100100001
10010000111100111001
10000000000000000001
10000000000000000001
11111111111111111111
