00000000000000000000
00000000000000000000
00000000000000000000
00000011110001111000
00000000000000001000
00000000000000001000
00000000000001111000
00001111000000000000
00001000000000000000
00001000000000000000
00001110011110000000
00000000000000000000
00000000000000000000
00000000000000000000
